**************
**** *       *
* *     **** *
* *** ****** *
*     ****** *
** ****S     *
** ***********
**   ***    **
**** *** ** **
*    *** ** **
* ****** ** **
*        ** **
*********** **
**************